1111111111111111111111111111111111
1E0000000000000C00000C00X00X0X0001
1010010100100000101001000000000101
1010010010101010001001000000010101
1P0000000C00C0000X00000000000000C1
1111111111111111111111111111111111